33333333333333333333333333333333333333333333333333333333333333333333333333333333333333333333333333333333333333333333333333333333
33333333333333333333333333333333333333333333333333333333333333333333333333333333333333333333333333333333333333333333333333333333
33333333333333331111111111111111111111111111111111111111111111111111111111111111111111111111111111111111111111111111111113333333
33333333333333331000000000000000000000000000000000000000000000000000000000000000000000000000000000000000000000000000000013333333
33333333333333331000000000000000000000000000000000000000000000000000000000000000000000000000000000000000000000000000000013333333
33333333333333331000000000000000000000000000000000000000000000000000000000000000000000000000000000000000000000000000000013333333
33333333333333331000000000000000000000000000000000000000000000000000000000000000000000000000000000000000000000000000000013333333
33333333333333331000000000000000000000000000000000000000000000000000000000000000000000000000000000000000000000000000000013333333
33333333333333331000000000000000000000000000000000000000000000000000000000000000000000000000000000000000000000000000000013333333
33333333333333331000000000000000000000000000000000000000000000000000000000000000000000000000000000000000000000000000000013333333
33333333333333331000000000000000000000000000000000000000000000000000000000000000000000000000000000000000000000000000000013333333
33333333333333331000000000000111111111111111111111111111111111111111111111111111111111111111111111111111111111100000000013333333
33333333333333331000000000001133333333333333333333333333333333333333333333333333333333333333333333333333333333110000000013333333
33333333333333331000000000001333333333333333333333333333333333333333333333333333333333333333333333333333333333310000000013333333
33333333333333331000000000001333333333333333333333333333333333333333333333333333333333333333333333333333333333310000000013333333
33333333333333331000000000001333333333333333333333333333333333333333333333333333333333333333333333333333333333310000000013333333
33333333333333331000000000001333333333333333333333333333333333333333333333333333333333333333333333333333333333310000000013333333
33333333333333331000000000001333333333333333333333333333333333333333333333333333333333333333333333333333333333310000000013333333
33333333333333331000000000001333333333333333333333333333333333333333333333333333333333333333333333333333333333310000000013333333
33333333333333331000000000001333333333333333333333333333333333333333333333333333333333333333333333333333333333310000000013333333
33333333333333331000000000001333333333333333333333333333333333333333333333333333333333333333333333333333333333310000000013333333
33333333333333331000000000001333333333333333333333333333333333333333333333333333333333333333333333333333333333310000000013333333
33333333333333331000000000001333333333333333333333333333333333333333333333333333333333333333333333333333333333310000000013333333
33333333333333331000000000001333333333333333333333333333333333333333333333333333333333333333333333333333333333310000000013333333
33333333333333331000000000001333333333333333333333333333333333333333333333333333333333333333333333333333333333310000000013333333
33333333333333331000000000001333333333333333333333333333333333333333333333333333333333333333333333333333333333310000000013333333
33333333333333331000000000001333333333333333333333333111111111111111111111111111111111111113333333333333333333310000000013333333
33333333333333331000000000001333333333333333333333333100000000000000000000000000000000000013333333333333333333310000000013333333
33333333333111111000000000001111113333333333333333333100000000000000000000000000000000000013333333333333333333310000000013333333
33333333333100000000000000000000013333333333333333333100000000000000000000000000000000000013333333333333333333310000000013333333
33333333333100000000000000000000013333333333333333333100000000000000000000000000000000000013333333333333333333310000000013333333
33333333333100000000000000000000013333333333333333333100000000000000000000000000000000000013333333333333333333310000000013333333
33333333333100000000000000000000013333333333333333333100000000000000000000000000000000000013333333333333333333310000000013333333
33333333333100000000000000000000013333333333333333333100000000000000000000000000000000000013333333333333333333310000000013333333
33333333333100000000000000000000013333333333333333333100000000000000000000000000000000000013333333333333333333310000000013333333
33333333333111111000000000001111113333333333333333333100000000000000000000000000000000000013333333333333333333310000000013333333
33333333333333331000000000001333333333333333333333333100000000000000000000000000000000000013333333333333333333310000000013333333
33333333333333331000000000001333333333333333333333333100000000000000000000000000000000000013333333333333333333310000000013333333
33333333333333331000000000001333333333333333333333333100000000000000000000000000000000000013333333333333333333310000000013333333
33333333333333331000000000001333333333333333333333333100000000000000000000000000000000000013333333333333333333310000000013333333
33333333333333331000000000001333333333333333333333333100000000000000000000000000000000000013333333333333333333310000000013333333
33333333333333331000000000001333333333333333333333333100000000000000000000000000000000000013333333333333333333310000000013333333
33333333333111111000000000001111113333333333333333333100000000000000000000000000000000000013333333333333333333310000000013333333
33333333333100000000000000000000013333333333333333333100000000000000000000000000000000000013333333333333333333310000000013333333
33333333333100000000000000000000013333333333333333333100000000011111111111111111000000000013333333333333333333310000000013333333
33333333333100000000000000000000013333333333333333333100000000113333331333333331100000000013333333333333333333310000000013333333
33333333333100000000000000000000013333333333333333333100000000133333331333333333100000000013333333333333333333310000000013333333
33333333333100000000000000000000013333333333333333333100000000133333331333333333100000000013333333333333333333310000000013333333
33333333333100000000000000000000013333333333333333333100000000133333331333333333100000000013333333333333333333310000000013333333
33333333333111111000000000001111113333333333333333333100000000133333331333333333100000000013333333333333333333310000000013333333
33333333333333331000000000001333333333333333333333333100000000133333331333333333100000000013333333333333333333310000000013333333
33333333333333331000000000001333333333333333333333333100000000133333331333333333100000000013333333333333333333310000000013333333
33333333333333331000000000001333333333333333333333333100000000133333331333333333100000000013333333333333333333310000000013333333
33333333333333331000000000001333333333333333333333333100000000133333331333333333100000000013333333333333333333310000000013333333
33333333333333331000000000001333333333333333333333333100000000133333331333333333100000000013333333333333333333310000000013333333
33333333333333331000000000001333333333333333333333333100000000133333331333333333100000000013333333333333333333310000000013333333
33333333333111111000000000001111113333333333333333333100000000133333331333333333100000000013333333333333333333310000000013333333
33333333333100000000000000000000013333333333333333333333333333333333331333333333100000000013333333333333333333310000000013333333
33333333333100000000000000000000013333333333333333333333333333333333331333333333100000000013333333333333333333310000000013333333
33333333333100000000000000000000013333333333333333333333333333333333331333333333100000000013333333333333333333310000000013333333
33333333333100000000000000000000013333333333333333333333333333333333331333333333100000000013333333333333333333310000000013333333
33333333333100000000000000000000013333333333333333333100000000133333331333333333100000000013333333333333333333310000000013333333
33333333333100000000000000000000013333333333333333333144444444133333331333333333100000000013333333333333333333310000000013333333
33333333333111111000000000001111113333333333333333333100000000133333331333333333144444444413333333333333333333310000000013333333
33333333333333331000000000001333333333333333333333333100000000133333331333333333100000000013333333333333333333310000000013333333
33333333333333331000000000001333333333333333333333333100000000133333331333333333333333333333333333333333333333310000000013333333
33333333333333331000000000001333333333333333333333333100000000133333331333333333333333333333333333333333333333310000000013333333
33333333333333331000000000001333333333333333333333333100000000133333331333333333333333333333333333333333333333310000000013333333
33333333333333331000000000001333333333333333333333333100000000133333331333333333333333333333333333333333333333310000000013333333
33333333333333331000000000001333333333333333333333333100000000133333331333333333100000000013333333333333333333310000000013333333
33333333333111111000000000001111113333333333333333333100000000133333331333333333100000000013333333333333333333310000000013333333
33333333333100000000000000000000013333333333333333333100000000133333331333333333100000000013333333333333333333310000000013333333
33333333333100000000000000000000013333333333333333333100000000133333331333333333100000000013333333333333333333310000000013333333
33333333333100000000000000000000013333333333333333333333333333333333331333333333100000000013333333333333333333310000000013333333
33333333333100000000000000000000013333333333333333333333333333333333331333333333100000000013333333333333333333310000000013333333
33333333333100000000000000000000013333333333333333333333333333333333331333333333100000000013333333333333333333310000000013333333
33333333333100000000000000000000013333333333333333333333333333333333331333333333100000000013333333333333333333310000000013333333
33333333333111111000000000001111113333333333333333333100000000133333331333333333100000000013333333333333333333310000000013333333
33333333333333331000000000001333333333333333333333333144444444133333331333333333100000000013333333333333333333310000000013333333
33333333333333331000000000001333333333333333333333333100000000133333331333333333144444444413333333333333333333310000000013333333
33333333333333331000000000001333333333333333333333333100000000133333331333333333100000000013333333333333333333310000000013333333
33333333333333331000000000001333333333333333333333333100000000133333331333333333333333333333333333333333333333310000000013333333
33333333333333331000000000001333333333333333333333333100000000133333331333333333333333333333333333333333333333310000000013333333
33333333333333331000000000001333333333333333333333333100000000133333331333333333333333333333333333333333333333310000000013333333
33333333333111111000000000001111113333333333333333333100000000133333331333333333333333333333333333333333333333310000000013333333
33333333333100000000000000000000013333333333333333333100000000133333331333333333100000000013333333333333333333310000000013333333
33333333333100000000000000000000013333333333333333333100000000133333331333333333100000000013333333333333333333310000000013333333
33333333333100000000000000000000013333333333333333333100000000133333331333333333100000000013333333333333333333310000000013333333
33333333333100000000000000000000013333333333333333333100000000133333331333333333100000000013333333333333333333310000000013333333
33333333333100000000000000000000013333333333333333333333333333333333331333333333100000000013333333333333333333310000000013333333
33333333333100000000000000000000013333333333333333333333333333333333331333333333100000000013333333333333333333310000000013333333
33333333333111111000000000001111113333333333333333333333333333333333331333333333100000000013333333333333333333310000000013333333
33333333333333331000000000001333333333333333333333333333333333333333331333333333100000000013333333333333333333310000000013333333
33333333333333331000000000001333333333333333333333333100000000133333331333333333100000000013333333333333333333310000000013333333
33333333333333331000000000001333333333333333333333333144444444133333331333333333100000000013333333333333333333310000000013333333
33333333333333331000000000001333333333333333333333333100000000133333331333333333144444444413333333333333333333310000000013333333
33333333333333331000000000001333333333333333333333333100000000133333331333333333100000000013333333333333333333310000000013333333
33333333333333331000000000001333333333333333333333333100000000133333331333333333333333333333333333333333333333310000000013333333
33333333333111111000000000001111113333333333333333333100000000133333331333333333333333333333333333333333333333310000000013333333
33333333333100000000000000000000013333333333333333333100000000133333331333333333333333333333333333333333333333310000000013333333
33333333333100000000000000000000013333333333333333333100000000133333331333333333333333333333333333333333333333310000000013333333
33333333333100000000000000000000013333333333333333333100000000133333331333333333100000000013333333333333333333310000000013333333
33333333333100000000000000000000013333333333333333333100000000133333331333333333100000000013333333333333333333310000000013333333
33333333333100000000000000000000013333333333333333333100000000133333331333333333100000000013333333333333333333310000000013333333
33333333333100000000000000000000011333333333333333331100000000133333331333333333100000000013333333333333333333310000000013333333
33333333333100000000000000000000001111111111111111111000000000133333331333333333100000000013333333333333333333310000000013333333
33333333333100000000000000000000000000000000000000000000000000133333331333333333100000000013333333333333333333310000000013333333
33333333333100000000000000000000000000000000000000000000000000133333331333333333100000000013333333333333333333310000000013333333
33333333333100000000000000000000000000000000000000000000000000133333331333333333100000000013333333333333333333310000000013333333
33333333333100000000000000000000000000000000000000000000000000133333331333333333100000000013333333333333333333310000000013333333
33333333333100000000000000000000000000000000000000000000000000133333331333333333100000000011333333333333333333110000000013333333
33333333333100000000000000000000000000000000000000000000000000133333331333333333100000000001111111111111111111100000000013333333
33333333333100000000000000000000000000000000000000000000000000133333331333333333100000000000000000000000000000000000000013333333
33333333333100000000000000000000000000000000000000000000000000133333331333333333100000000000000000000000000000000000000013333333
33333333333100000000000000000000000000000000000000000000000000133333331333333333100000000000000000000000000000000000000013333333
33333333333100000000000000000000000000000000000000000000000000133333331333333333100000000000000000000000000000000000000013333333
33333333333100000000000000000000000000000000000000000000000000133333331333333333100000000000000000000000000000000000000013333333
33333333333100000000000000000000000000000000000000000000000000133333331333333333100000000000000000000000000000000000000013333333
33333333333100000000000000000000000000000000000000000000000000133333331333333333100000000000000000000000000000000000000013333333
33333333333100000000000000000000000000000000000000000000000000133333331333333333100000000000000000000000000000000000000013333333
33333333333100000000000000000000000000000000000000000000000000133333331333333333100000000000000000000000000000000000000013333333
33333333333111111111111111111111111111111111111111111111111111133333331333333333100000000000000000000000000000000000000013333333
33333333333333333333333333333333333333333333333333333333333333333333331333333333100000000000000000000000000000000000000013333333
33333333333333333333333333333333333333333333333333333333333333333333331333333333100000000000000000000000000000000000000013333333
33333333333333333333333333333333333333333333333333333333333333333333331333333333111111111111111111111111111111111111111113333333
33333333333333333333333333333333333333333333333333333333333333333333331333333333333333333333333333333333333333333333333333333333
33333333333333333333333333333333333333333333333333333333333333333333331333333333333333333333333333333333333333333333333333333333
33333333333333333333333333333333333333333333333333333333333333333333333333333333333333333333333333333333333333333333333333333333
