33333333333332222222222222222222222222222222222222222222222222222222222222222222222222222222223333333333333333333333333333333333
33333333332220000000000000000000000000000000000000000000000000000000000000000000000000000000002233333333333333333333333333333333
33333333220000000000000000000000000000000000000000000000000000000000000000000000000000000000000023333333333333333333333333333333
33333332000000000000000000000000000000000000000000000000000000000000000000000000000000000000000002333333333333333333333333333333
33333320000000000000000000000000000000000000000000000000000000000000000000000000000000000000000000233333333333333333333333333333
33333200000000000000000000000000000000000000000000000000000000000000000000000000000000000000000000023333333333333333333333333333
33332000000000000000000000000000000000000000000000000000000000000000000000000000000000000000000000023333333333333333333333333333
33332000000000000000000000000000000000000000000000000000000000000000000000000000000000000000000000002333333333333333333333333333
33320000000000000000000000000000000000000000000000000000000000000000000000000000000000000000000000002333333333333333333333333333
33320000000000000000000000000000000000000000000000000000000000000000000000000000000000000000000000002333333333333333333333333333
33320000000000000222222222222222222222222222222222222222222222222222222222222222222222000000000000002333333333333333333333333333
33320000000000023333333333333333333333333333333333333333333333333333333333333333333333200000000000002333333333333333333333333333
33320000000000233333333333333333333333333333333333333333333333333333333333333333333333320000000000002333333333333333333333333333
33320000000002333333333333333333333333333333333333333333333333333333333333333333333333320000000000002333333333333333333333333333
33320000000002333333333333333333333333333333333333333333333333333333333333333333333333320000000000002333333333333333333333333333
33320000000023333333333333333333333333333333333333333333333333333333333333333333333333320000000000002333333333333333333333333333
33320000000023333333333333333333333333333333333333333333333333333333333333333333333333320000000000002333333333333333333333333333
33320000000023333333333333333333333333333333333333333333333333333333333333333333333333320000000000002333333333333333333333333333
33320000000023333333333333333333333333333333333333333333333333333333333333333333333333320000000000002333333333333333333333333333
33320000000023333333333333333333333333333333333333333333333333333333333333333333333333320000000000002333333333333333333333333333
33320000000023333333333333333333333333333333333333333333333333333333333333333333333333320000000000002333333333333333333333333333
33320000000023333333333333333333333333333333333333333333333333333333333333333333333333320000000000002333333333333333333333333333
33320000000023333333333333333333333333333333333333333333333333333333333333333333333333320000000000002333333333333333333333333333
33320000000023333333333333333333333333333333333333333333333333333333333333333333333333320000000000002333333333333333333333333333
33320000000023333333333333333333333333333333333333333333333333333333333333333333333333320000000000002333333333333333333333333333
33320000000023333333333333333333333333333333333333333333333333333333333333333333333333320000000000002333333333333333333333333333
33320000000023333333333333333333333333333333333333333333333333333333333333333333333333320000000000002333333333333333333333333333
33320000000023333333333333333333333333333333333333333333333333333333333333333333333333320000000000002333333333333333333333333333
33320000000023333333333333333333333333333333333333333333333333333333333333333333333333320000000000002333333333333333333333333333
33320000000023333333333333333333333333333333333333333333333333333333333333333333333333320000000000002333333333333333333333333333
33320000000023333333333333333333333333333333333333333333333333333333333333333333333333320000000000002333333333333333333333333333
33320000000023333333333333333333333333333333333333333333333333333333333333333333333333320000000000002333333333333333333333333333
33320000000023333333333333333333333333333333333333333333333333333333333333333333333333320000000000002333333333333333333333333333
33320000000023333333333333333333333333333333333333333333333333333333333333333333333333320000000000002333333333333333333333333333
33320000000023333333333333333333333333333333333333333333333333333333333333333333333333320000000000002333333333333333333333333333
33320000000023333333333333333333333333333333333333333333333333333333333333333333333333320000000000002333333333333333333333333333
33320000000023333333333333333333333333333333333333333333333333333333333333333333333333320000000000002333333333333333333333333333
33320000000023333333333333333333333333333333333333333333333333333333333333333333333333320000000000002333333333333333333333333333
33320000000023333333333333333333333333333333333333333333333333333333333333333333333333320000000000002333333333333333333333333333
33320000000023333333333333333333333333333333333333333333333333333333333333333333333333320000000000002333333333333333333333333333
33320000000023333333333333333333333333333333333333333333333333333333333333333333333333320000000000002333333333333333333333333333
33320000000023333333333333333333333333333333333333333333333333333333333333333333333333320000000000002333333333333333333333333333
33320000000023333333333333333333333333333333333333333333333333333333333333333333333333320000000000002333333333333333333333333333
33320000000023333333333333333333333333333333333333333333333333333333333333333333333333320000000000002333333333333333333333333333
33320000000023333333333333333333333333333333333333333333333333333333333333333333333333320000000000002333333333333333333333333333
33320000000023333333333333333333333333333333333333333333333333333333333333333333333333320000000000002333333333333333333333333333
33320000000023333333333333333333333333333333333333333333333333333333333333333333333333200000000000002333333333333333333333333333
33320000000023333333333333333333333333333333333333333333333333333333333333333333333332000000000000002333333333333333333333333333
33320000000023333333333333333333333333333222222222222222222222222222222222222222222220000000000000002333333333333333333333333333
33320000000023333333333333333333333333322000000000000000000000000000000000000000000000000000000000002333333333333333333333333333
33320000000023333333333333333333333333200000000000000000000000000000000000000000000000000000000000002333333333333333333333333333
33320000000023333333333333333333333332000000000000000000000000000000000000000000000000000000000000002333333333333333333333333333
33320000000023333333333333333333333320000000000000000000000000000000000000000000000000000000000000023333333333333333333333333333
33320000000023333333333333333333333200000000000000000000000000000000000000000000000000000000000000023333333333333333333333333333
33320000000023333333333333333333333200000000000000000000000000000000000000000000000000000000000000233333333333333333333333333333
33320000000023333333333333333333332000000000000000000000000000000000000000000000000000000000000002333333333333333333333333333333
33320000000023333333333333333333332000000000000000000000000000000000000000000000000000000000000223333333333333333333333333333333
33320000000023333333333333333333320000000000000022222222222222222222222222222222222222222222222333333333333333333333333333333333
33320000000023333333333333333333320000000000000233333333333333333333333333333333333333333333333333333333333333333333333333333333
33320000000023333333333333333333320000000000002333333333333333333333333333333333333333333333333333333333333333333333333333333333
33320000000023333333333333333333320000000000002333333333333333333333333333333333333333333333333333333333333333333333333333333333
33320000000023333333333333333333320000000000002333333333333333333333333333333333333333333333333333333333333333333333333333333333
33320000000023333333333333333333320000000000002333333333333333333333333333333333333333333333333333333333333333333333333333333333
33320000000023333333333333333333320000000000002333333333333333333333333333333333333333333333333333333333333333333333333333333333
33320000000023333333333333333333320000000000002333333333333333333333333333333333333333333333333333333333333333333333333333333333
33320000000023333333333333333333320000000000002333333333333333333333333333333333333333333333333333333333333333333333333333333333
33320000000023333333333333333333320000000000002333333333333333333333333333333333333333333333333333333333333333333333333333333333
33320000000023333333333333333333320000000000002333333333333333333333333333333333333333333333333333333333333333333333333333333333
33320000000023333333333333333333320000000000002333333333333333333333333333333333333333333333333333333333333333333333333333333333
33320000000023333333333333333333320000000000002333333333333333333333333333333333333333333333333333333333333333333333333333333333
33320000000023333333333333333333320000000000002333333333333333333333333333333333333333333333333333333333333333333333333333333333
33320000000023333333333333333333320000000000002333333333333333333333333333333333333333333333333333333333333333333333333333333333
33320000000023333333333333333333320000000000002333333333333333333333333333333333333333333333333333333333333333333333333333333333
33320000000023333333333333333333320000000000002333333333333333333333333333333333333333333333333333333333333333333333333333333333
33320000000023333333333333333333320000000000002333333333333333333333333333333333333333333333333333333333333333333333333333333333
33320000000023333333333333333333320000000000002333333333333333333333333333333333333333333333333333333333333333333333333333333333
33320000000023333333333333333333320000000000000233333333333333333333333333333333333333333333333333333333333333333333333333333333
33320000000023333333333333333333320000000000000002333333333333333333333333333333333333333333333333333333333333333333333333333333
33320000000023333333333333333333320000000000000000022222222222222222222222222222222222222222222222222222222222222222222233333333
33320000000023333333333333333333320000000000000000000000000000000000000000000000000000000000000000000000000000000000000023333333
33320000000023333333333333333333332000000000000000000000000000000000000000000000000000000000000000000000000000000000000002333333
33320000000023333333333333333333332000000000000000000000000000000000000000000000000000000000000000000000000000000000000000233333
33320000000023333333333333333333333200000000000000000000000000000000000000000000000000000000000000000000000000000000000000023333
33320000000023333333333333333333333320000000000000000000000000000000000000000000000000000000000000000000000000000000000000023333
33320000000023333333333333333333333332200000000000000000000000000000000000000000000000000000000000000000000000000000000000002333
33320000000023333333333333333333333333322222222222222222222222222222222222222222222222222222222222222222222222222200000000002333
33320000000023333333333333333333333333333333333333333333333333333333333333333333333333333333333333333333333333333320000000002333
33320000000023333333333333333333333333333333333333333333333333333333333333333333333333333333333333333333333333333332000000002333
33320000000023333333333333333333333333333333333333333333333333333333333333333333333333333333333333333333333333333332000000002333
33320000000023333333333333333333333333333333333333333333333333333333333333333333333333333333333333333333333333333332000000002333
33320000000023333333333333333333333333333333333333333333333333333333333333333333333333333333333333333333333333333332000000002333
33320000000023333333333333333333333333333333333333333333333333333333333333333333333333333333333333333333333333333332000000002333
33320000000023333333333333333333333333333333333333333333333333333333333333333333333333333333333333333333333333333332000000002333
33320000000023333333333333333333333333333333333333333333333333333333333333333333333333333333333333333333333333333332000000002333
33320000000023333333333333333333333333333333333333333333333333333333333333333333333333333333333333333333333333333332000000002333
33320000000023333333333333333333333333333333333333333333333333333333333333333333333333333333333333333333333333333332000000002333
33320000000023333333333333333333333333333333333333333333333333333333333333333333333333333333333333333333333333333332000000002333
33320000000023333333333333333333333333333333333333333333333333333333333333333333333333333333333333333333333333333332000000002333
33320000000023333333333333333333333333333333333333333333333333333333333333333333333333333333333333333333333333333332000000002333
33320000000023333333333333333333333333333333333333333333333333333333333333333333333333333333333333333333333333333332000000002333
33320000000023333333333333333333333333333333333333333333333333333333333333333333333333333333333333333333333333333332000000002333
33320000000023333333333333333333333333333333333333333333333333333333333333333333333333333333333333333333333333333332000000002333
33320000000023333333333333333333333333333333333333333333333333333333333333333333333333333333333333333333333333333332000000002333
33320000000023333333333333333333333333333333333333333333333333333333333333333333333333333333333333333333333333333332000000002333
33320000000023333333333333333333333333333333333333333333333333333333333333333333333333333333333333333333333333333332000000002333
33320000000023333333333333333333333333333333333333333333333333333333333333333333333333333333333333333333333333333332000000002333
33320000000023333333333333333333333333333333333333333333333333333333333333333333333333333333333333333333333333333332000000002333
33320000000023333333333333333333333333333333333333333333333333333333333333333333333333333333333333333333333333333332000000002333
33320000000023333333333333333333333333333333333333333333333333333333333333333333333333333333333333333333333333333332000000002333
33320000000002333333333333222222222222222222222222222222222223333333333333333333333333333333333333333333333333333332000000002333
33320000000002333333333222000000000000000000000000000000000002223333333333333333333333333333333333333333333333333332000000002333
33320000000000233333222000000000000000000000000000000000000000002223333333333333333333333333333333333333333333333220000000002333
33320000000000022222000000000000000000000000000000000000000000000002223333333333333333333333333333333333322222222000000000002333
33320000000000000000000000000000000000000000000000000000000000000000002222222222222222222222222222222222200000000000000000002333
33332000000000000000000000000000022222222222222222222200000000000000000000000000000000000000000000000000000000000000000000002333
33332000000000000000000000000002233333333333333333333222000000000000000000000000000000000000000000000000000000000000000000002333
33333200000000000000000000000002233333333333333333333322000000000000000000000000000000000000000000000000000000000000000000023333
33333320000000000000000000000000022222222222222222222200000000000000000000000000000000000000000000000000000000000000000000233333
33333332200000000000000000000000000000000000000000000000000000000000002222222222222222222222222222222222200000000000000002333333
33333333322222222222000000000000000000000000000000000000000000000002223333333333333333333333333333333333322222222222222223333333
33333333333333333333222000000000000000000000000000000000000000002223333333333333333333333333333333333333333333333333333333333333
33333333333333333333333222000000000000000000000000000000000002223333333333333333333333333333333333333333333333333333333333333333
33333333333333333333333333222222222222222222222222222222222223333333333333333333333333333333333333333333333333333333333333333333
33333333333333333333333333333333333333333333333333333333333333333333333333333333333333333333333333333333333333333333333333333333
33333333333333333333333333333333333333333333333333333333333333333333333333333333333333333333333333333333333333333333333333333333
33333333333333333333333333333333333333333333333333333333333333333333333333333333333333333333333333333333333333333333333333333333
33333333333333333333333333333333333333333333333333333333333333333333333333333333333333333333333333333333333333333333333333333333
33333333333333333333333333333333333333333333333333333333333333333333333333333333333333333333333333333333333333333333333333333333
